R     500 500
WE    res/wall_w.xpm


NO    res/wall_n.xpm
EA    res/wall_e.xpm

S     res/sprite.xpm

C     255,255,255
F     127,127,255
SO    res/wall_s.xpm

 111111
 1    1
 100N01
 111111
