R 800 600
NO res/wall_n.xpm
SO res/wall_s.xpm
WE res/wall_w.xpm
EA res/wall_e.xpm
S res/sprite.xpm
F 127,127,255
C 100,100,100
1111111111111111111111111111111
1000000000000000000000000000001
1002000000000000000200000000001
1000000000000000000200000020001
1000110110000000000200000000001
1000100010000000000000000000001
100010N010000000000000000000001
1000100010000000001100111000001
1000111110000000001000021000001
1000000000000000001000001111111
1000000000000000001000001000001
1000000002000000001000000002001
1000000000000000001000001000001
1111111111111111111111111111111
