R 1280 1024
NO res/wall_n.xpm
SO res/wall_s.xpm
WE res/wall_w.xpm
EA res/wall_e.xpm
S res/sprite.xpm
F 127,127,255
C 100,100,100
11111111111111
10000000000001
10020000000201
10000000000201
10001101100201
10001000100001
100010N0100001
10001000100001
10001111100001
10000000000001
10000000000001
10000000020001
10000000000001
11111111111111
