R 640 480
NO res/wall_n.xpm
SO res/wall_s.xpm
WE res/wall_w.xpm
EA res/wall_e.xpm
S res/wall_n.xpm
F 127,127,127
C 255,0,0
1111111111111111111
1000000000000000001
1000110000000110001
1000110000000110001
1000110000000110001
1000110000000000001
1000000000000000001
1000110000000110001
1000110000000000001
1000000000000000001
1000001100000110001
1000001100000110001
1000000000000000001
100000000N000110001
1000110000000110001
1000110000000110001
1000110000000110001
1000110000000000001
1000000000000000001
1000110000000110001
1000110000000110001
1000110000000000001
1000000000000000001
1000110000000110001
1000110000000000001
1000000000000000001
1111111111111111111
