R 1280 720

NO res/wall_n.xpm
SO res/wall_s.xpm
WE res/wall_w.xpm
EA res/wall_e.xpm

S res/sprite.xpm

F 127,127,255
C 100,100,100

111111111111111111111111111111111111111111111111
100000000000000000000001000000000100000000000021
100200000000000000020001000000100100000000000001
100000000000000000020001002000100100000000000001
100011011000000000020001000000100111000000000001
100010001000000000000000000000100001001000000001
100010E01000000000000000000000100001001000020001
100010001000000000110011100000100000001001000001
100011111000000000100002100000101111111111000001
100000000000000000100000111111100001000000000001
100000000000000000100000100000100001000000000001
100000000200000000100000000200100001000000020001
100000000000000000100000100000100000000000000001
111111111111111111111111111111111111111111111111
