.! Map using bonus stuff

R 800 600

NO res/wall_tex_a.xpm
SO res/wall_tex_b.xpm
WE res/wall_tex_b.xpm
EA res/wall_tex_b.xpm
S res/spr_tex_a.xpm

F 51,46,96
C 239,238,143

.. Bonus parameters

DE 0 Ghost 0 100 res/spr_tex_a.xpm
DE 1 Coin 0 100 res/a coin.xpm
DE 2 Mask 0 100 res/angry_mask.xpm
DE 3 Vampire 1 100 res/green_vampire.xpm
IT 0 -50
IT 1 10
HP 75

1111111111
1000000001
1000A00001
1000000001
1000N00001
10000000B1
1011111101
10BBB00001
1000000001
1A001100A1
1000000001
1000000001
1110000111
1001001001
1111100001
1000000001
1001111111
1001000001
1001000001
1001001001
1000001001
1000001001
1111111001
1000001001
1000001001
1000001001
1000001001
1000001001
1000001AA1
1000001001
1000001001
1000001001
1000001001
1000001001
1000001001
1000001001
1000001001
1111001001
1000001001
1000001001
1000001001
1000001001
100000A001
1000001001
1000001001
1000000001
1000001001
1000000001
1100000001
1010001001
1000010001
1000000001
1111111111
