.. Perfect map to introduce leaks in
.! A bit of fun to prove the leaktest works

R 800 600


.. Multiple linebreaks!



NO res/wall_n.xpm
SO res/wall_s.xpm
WE res/wall_w.xpm
EA res/wall_e.xpm
S res/spr_tex_a.xpm

F 40, 40, 40
C 70, 70, 70

111111111111111111111111111111111111111111111111
1              00              00              1
1              11              11       1      1
1              11              11       1      1
1             2   1            11              1
111111111111111   1111111111111111111111 1111111
111111111111111   111111111111111111111101111111
1              000             11              1
1              11              00              1
1              11              11   2          1
1              11              11              1
1 1111111111111111111110011111111111111  1111111
11111111111111111111110011111111111111  11111111
               11              11              1
               11                              1
      1        11              11       N      1
      0        11              11              1
               111111111111111111111111111111111

               1

